-----------------
-       #       -
------ #2       -
-H###-        ##-
-3# +-        #2-
-    -        ##-
-    x1         -
-    -         c-
-----------------
