---------------------
-       - -+-       -
--- - - -   -       -
-       --3--       -
- - - - -   x       -
-       - - ---==-- -
- --- - ----- -==-  -
-+-H-            #2--
---x--------- -==-  -
-- 3 - - c1----==-- -
-      - - -   ##   -
--   - -   3  -2- - -
---1-- ------   1   -
-    -      - - - - -
-    -         1    -
-    -#     - - - - -
-  c -2#    -       -
---------------------
     
